Grass - "G"
Left Corner Grass - "/"
Right Corner Grass - "\"
Rock - "R"
Left Corner Rock - "<"
Right Corner Rock - ">"
Down Rock - "_"
Down Left Corner Rock - "-"
Down Right Corner Rock - "+"
Climb Grass - "="
Down Climb Grass - "%"
Platform Grass - "."
Platform Left Grass - "{"
Platform Right Grass - "}"
Non-Split Platform - "^"
Connect Ground Left- "!"
Connect Ground Right- "@"
Connect Sky Left - "?"
Connect Sky Right - "#"
Uka - "U"
Crackatoo - "C"
Flyling - "F"
Spikes - "S"
Lava - "L"
Lava Left Corner - "["
Lava Right Corner - "]"
Ice - "I"
Ice Left Corner - "("
Ice Right Corner - ")"
Hero - "H"
Teleport - "T"
Blank - "b"
Skeleton - "$"
Plant - "P"
Wall - "*"